
EA textures/txt1.png
WE textures/txt2.png
SO textures/txt3.png
NO textures/txt4.png
F 184,113,39
C 51,198,007
11111111111111111111111111111
10110000011100001000000000001
10010000000000001000000000001
10110000000000000000000010001
10000000000N00000000000000001
11110111111111011100000010001
11110111111111011101010010001
10000000001000010000000001001
10000000001101000000000000001
10000000000100000001010000001
11111111111111111111111111111