

NO textures/wall_1.xpm
SO textures/wall_0.xpm
WE textures/wall_3.xpm
EA textures/wall_4.xpm
F 184,113,39
C 51,198,007
11111111111111111111111111111
10110000011100001000000000001
10010000000000001000N00000001
10110000011100000000000010001
10000000001100000000000000001
11110111111111011100000010001
11110111111111011101010010001
10000000001000010000000001001
10000000001101000000000000001
10000000000100000001010000001
11111111111111111111111111111