EA       ./textures/txt1.png
 WE ./textures/txt3.png



SO ./textures/txt2.png



NO ./textures/txt4.png
F 220,100,5
C 225,30,255


        1111111111111111111111111
        1000000000110000000000001
        1011000001110000000000001
        10010000000000000000000001
111111111011000001110000000000001
10000000111111000001110111111111111
111101111   111101110000001001
11110111111111011101010010001
11000000110101011100000010001
10001110000000N01100000010001
11000001110101011111011110001
11110111 1110101 101111010001
11111111 1111111 111111111111