EA       ./textures/txt1.png





 WE ./textures/txt3.png



SO ./textures/txt3.png



NO ./textures/txt4.png




F      1,1,95
C   1,1,1   


    
11111
11N11
11111